
NO textures/blue.xpm
SO textures/red.xpm
WE textures/yellow.xpm
EA textures/green.xpm

F 220,100,0
C 225,30,0

1111111111111111111111111111111111111111111111111111111111111111111111111111111111111111111111111111111111111111111111111111111111111111111111111111111111
1000000000000000000000111111111111100000000000000000000000000000000000000000000000000000000000000000000000000000000000000000000000000000000000000000000001
100000000000000000000011111111111110000000000000000000000000000000000000000000000000000000000000000000000000000000000000000000000000000000000000000000000111111111111111111
100000000000000000000011111111111110000000000000000000000000000000000000000000111111111111111111100000000000111111111111110000000000000000000000000000000000000000000000001
100000000000000000000011111111111110000000000000000000000000000000000000000000111111111111111111100000000000111111111111110000000000000000000000000000000000000000000000001
100000000000000000000011111111111110000000000000000000000000000000000000000000111111111111111111100000000000111111111111110000000000000000000000000000000000000000000000001
10000000000000000000001111111111111100000000000000000000000W0000000000000000000111111111111111111100000000000111111111111110000000000000000000000000000000000000000000000001
1000000000000000000000111111111111110000000000000000000000000000000000000000000111111111111111111100000000000111111111111110000000000000000000000000000000000000000000000001
100000000000000000000000000000000011111111111100000000000000000000000000000000111111111111111111100000000000111111111111110000000000000000000000000000000000000000000000001
100000000000000000000000000000000011111111111100000000000000000000000000000000111111111111111111100000000000111111111111110000000000000000000000000000000000000000000000001
100000000000000000111100000000000011111111111100000000000000000000000000000000000000000000000000000000000000000000000000000000000000000000000000000000000000011111111111111
10000000000000000011110000000000001111111111110000000000000000000000000000000000000000000000000000000000000000000000000000000000000000000000000000000000000001
10000000000000000011110000000000001111111111110000000000000000000000000001111111110000000000000000000000000000000000000000000000000000000000000000000000000001
1000000000000000001111000000000000111111111110000000000000000000000000001111111110000000000000000000000000000000000000000000000000000000000000000000000000001
1000000000000000001111000000000000111111111110000000000000000000000000001111111110000000000000000000000000000000000000000000000000000000000000000000000000001
1000000000000000001111000000000000000000000000000000000000000111111111000000000000000000000000000000000000000000000000000000000000000000000000000111111111111
100000000000000000111100000000000000000000000000000000000000011111111100000000000000000000000000000000000000000000111111111100000000000000000000000000000001
100000000000000000000000000000000000000000000000000000000111111111000000000000000000000000000000000000000000001111111111000000000000000000000000000000011111
10000000000000000000000000000000000000000000000000000000011111111100000000000000000000000000000000000000000000111111111100000000000000000000000000000001
10000000000000000000000000000000000000000000000000000000000000000000000000000000000000000000000000000000000000111111111100000000000000000000000000000001
10000000000000000000000000000000000000000000000000000000000000000000000000000000000000000000000000000000000000111111111100000000000000000000000000000001
10000000000000000000000000000000000000000000000000000000000000000000000000000000000000000000000000000000000000111111111100000000000000000000000000000001
10000000000000000000000000000000000000000000000000000000000000000000000000000000000000000000000000000000000000111111111100000000000000000000000000000001
10000000000000000000000000000000000000000000000000000000000000000000000000000000000000000000000000000000000000000000000000000000000000000000011111111111
1000000000000000000000000000000000011111100000000000000000000000000000000000000000000000000000000000000000000000000000000000000000000000000000000001
1000000000000000000000000000000000011111100000000000000000000000000000000000000000000000000000000000000000000000000000000000000000000000000000000001
10000000000000000000000000000000000111111000000000000000000000000000000000000000000000000000000000000000000000000000000000000000000000000000000000011
100000000000000000000000000000000001111110000000000000000000000000000000000000000000000000000000000000000000000000000000000000110000000000000000000001
100000000000000000000000000000000001111110000000000000000000000000000000000000000000000000000000000000000000000000000000000000110000000000000000000001
100000000000000000000000000000000001111110000000000000000000000000000000000000000000000000000000000000000000000000000000000000110000000000000000000001
100000000000000000000000000000000001111110000000000000000000000000000000000000000000000000000000000000000000000000000000000000110000000000000000000001
100000000000000000000000000000000000000000000000000000000000000000000000000000000000000000000000000000000000000000000000110000000000000000000001111111
100000000000000000000000000000000000000000000000000000000000000000000000000000000000000000000000000000000000000000000000110000000000000000000001
100000000000000000000000000000000000000000000000000000000000000000000000000000000000000000000000000000000000000000000000110000000000000000000001
10000000000000000000000000000000000000000000000000000000000000000000000000000000000000000000000000000000000000000000000000000000000000000000011
1000000000000000000000000000000000000000000000000000000000000000000000000000000000000000000000000000000000000000000000000000000000000000000001
1111111111111111111111111111111111111111111111111111111111111111111111111111111111111111111111111111111111111111111111111111111111111111111111