
NO textures/Microscheme_0.xpm
SO textures/painting-21.xpm
WE textures/publicdomainpictures.net-zebra-skin-11297062987mjt.xpm
EA textures/wash_a-new.xpm

F 220,100,0
C 225,30,0

11111111111111111
11110011100001111
1100000N000000011
11110011100001111
11111111111111111
