
NO textures/windows/a.xpm
SO textures/windows/b.xpm
WE textures/windows/c.xpm
EA textures/windows/d.xpm

F 0,123,121
C 05,123,121

11111111111111111
11110011100001111
1100000E000000011
11110011100001111
11111111111111111
