
NO textures/cube/Techa/j.xpm
SO textures/cube/Techa/e.xpm
WE textures/cube/Techa/a.xpm
EA textures/cube/Techa/g.xpm

F 225,225,225
C 0,0,0


11111111111111111
11110011100001111
1100000E000000011
11110011100001111
11111111111111111
