
NO textures/cube/Techa/a.xpm
SO textures/cube/Techa/c.xpm
WE textures/cube/Techa/d.xpm
EA textures/cube/Techa/b.xpm

F 0,0,0
C 10,0,0


11111111111111111
11110011100001111
1100000E000000011
11110011100001111
11111111111111111