NO maps/Microscheme_0.xpm
SO maps/painting-21.xpm
WE maps/publicdomainpictures.net-zebra-skin-11297062987mjt.xpm
EA maps/wash_a-new.xpm

F 220,25,0
C 225,30,0

        1111111111111111111111111
        1000000000110000000100001
        1011000001110000000100001
        1001000000000000000100001
111111111011000001110000000100001
1S0100000011000001110111111111111
11110111111111011100000010001
11110111111111011101010010001
11010000110100011100000010001
11110000000000001100000010001
10000000000000001101010010001
11000001110101011111011110001
11110111 1110101 101111010001
11111111 1111111 111111111111
